XXXXXXXXXX
X    | XSX
X    X X-X
XXXX X X X
X    X X X
X XXXX   X
X    XXXXX
XXX    XXX
XE  X  XXX
XXXXXXXXXX